111111111111111
1P000000E0000C1
1CCCCCCCCCCCCC1
111111111111111
