111111
100CE1
1P0001
1C1CC1
111111
