111111
1001E1
1P0001
1C1CC1
111111